+++++++++++++++++++++++++++
+           ++            +
+           ++            +
+  +++  ++  ++  +++  +++  +
+        +      +         +
+        +      +         +
++++++  ++++  ++++  +++++++
----++  ++------++  ++
----++  ++---c--++  ++
----++  ++------++  ++
++++++  ++++  ++++  +++++++
+                         +
+                         +
+++++++++++++++++++++++++++